6 x 6
******
* R R*
*  * *
*  H *
*    *
******